Question	Answer	Annotation (Label)
La côte ?	Audrey l'a lu dans ces magazines, n'est-ce pas, Audrey ?	5
Audrey l'a lu dans ces magazines, n'est-ce pas, Audrey ?	Une star d'Hollywood était censé l'avoir acheté, mais non, M. et Mme Owen l'ont fait.	1
Une île ? Près de la mer ?	Les îles sont généralement près de la mer.	1
Et c'est pour une pièce ? Pour les grands théâtres ? Et serais-je crédité dans le programme ?	Mesdames et messieurs !	6
Êtes-vous M. Narracott ?	Personne d'autre ne tient l'écriteau.	1
- Le juge Wargrave ? L'honneur est pour moi.	À la retraite maintenant.	1
Vous venez ou pas ?	Allons-y.	1
Allons-y.	Par ici, juste là-haut.	1
Pardon, il y a un problème ?	Mes honoraires ne m'emmèneront que jusque là, monsieur.	1
Mme Owen a laissé des instructions pour moi ? - Je suis la secrétaire.	- Seulement de veiller à votre confort et que vous ayez tout ce que vous souhaitiez, Mlle Claythorne.	4
- Puis-je vous aider ? Voilà.	- Trop aimable.	1
Je ne peux pas l'habiller, non ?	Allez.	1
Un choc, peut-être ? Un changement soudain ?	Excusez-moi, madame, je l'ignore.	4
Sommes-nous dans les temps ?	Tout juste.	1
Puis-je vous emmener au salon ? Peut-être vous servir un apéritif, pendant que vous attendez les autres.	M. Davis. Vous avez l'air d'un homme qui a besoin d'un verre.	6
Mademoiselle ? Vous cherchez quelque chose ? Parce que ce sont les dépendances. Pour le personnel.	Eh bien, je suis du personnel.	4
Nous avons démarré sur le mauvais pied, n'est-ce pas ? Bien que vous ayez de belles jambes. Il aurait été idiot de ne pas les remarquer.	Vous semblez croire que je suis un type particulier de femme.	2
Un verre, M. Marston ?	Un gin rose. Rose comme le rougissement d'une vierge.	1
Êtes-vous un parieur, Lombard ?	Cela dépend.	3
Qu'en dites-vous ? Un pari ?	Les chances sont trop certaines.	2
Nous nous sommes rencontrés avant, vous savez ?	Pardonnez-moi, ma mémoire n'est plus ce qu'elle était.	4
Des amis à vous, M. Davis ?	Des relations d'affaires.	2
Le corps médical de l'armée royale, je présume, Dr Armstrong ?	C'est exact.	1
N'ont-ils pas téléphoné ?	Il n'y a pas de téléphone sur l'île.	2
Les Owen...Ils sont du genre festifs ?	"Festifs" ?	5
"Festifs" ?	Oui, parce que c'est un tantinet calme ici.	5
Votre voiture, la Jensen ?	Vous l'avez vue ? N'est-elle pas magnifique ?	1
Vous l'avez vue ? N'est-elle pas magnifique ? Je ne peux imaginer aimer quelqu'un autant que je vénère et adore les Jensen.	Vous m'avez fait sortir de la route.	1
Vous m'avez fait sortir de la route et vous avez le culot de dire que j'ai causé ça ?	Attention, mon vieux. Vous devenez tout rouge là.	4
Beau travail.	Rogers, je n'ai plus de cigarettes.	6
En avez-vous gagné ?	Je hais ces usages ; laisser les hommes à leur cigares et leurs "histoires".	6
Est-ce le moment ?	Commencez à servir.	1
- Un disque ?	- Cela se nomme un chant du cygne.	1
Rien n'est vrai, alors ?	Mlle Brady était comme de la famille pour nous.	6
21 hommes ?	J'ai toujours pensé que quelqu'un jaserait.	5
Nous ne devrions pas nous abaisser à encore débattre de ces accusations. - D'accord ?	- Certainement.	1
Vous conduisiez, n'est-ce pas ? Quelle surprise !	C'était de la malchance, voilà tout.	1
- Vous allez bien ? - Il s'étouffe !	Il saigne !	2
Pouvez-vous venir, s'il vous plaît ?	Elle est morte depuis quelques heures.	5
L'état de Mme Rogers a empiré ?	En quelque sorte.	1
- Morte ?	- Durant son sommeil.	1
Il y en a huit, n'est-ce pas ? Huit statuettes pour les huit personnes vivantes. Dites-moi que j'ai raison.	Je suis sûr qu'il y a une explication rationnelle à cela.	4
Sorti pour patauger, général ?	Qu'êtes-vous, Lombard ? Un mercenaire ? Un tueur à gages ? Un soldat ?	6
Qu'êtes-vous, Lombard ? Un mercenaire ? Un tueur à gages ? Un soldat ? Pas d'une armée que je reconnaîtrais, et pourtant, un soldat tout de même.	Vous n'avez pas à vous inquiéter de ce que je suis.	4
Il y a toujours un moment, n'est-ce pas ? Avant l'attaque, la montée, le bombardement, le chaos. Un moment de calme absolu.	Écoutez, ne dirait-on pas ce moment ?	5
Écoutez, ne dirait-on pas ce moment ?	Je n'ai jamais été un homme qui aime le calme, général.	2
Rupert ?	Qui est-ce? Il est un peu occupé à mourir, Agent Ryan.	5
Mais une Interpol agent-- que ce genre de risque, est-ce pas?	Rupert a dû trébuché sur quelque chose	1
Vous effectivement parlé à Python? Vous avez entendu la voix du bâtard au téléphone?	Ouais.	1
Donc, si il a fait cela avant, vous devez avoir ces autres armes à feu ?	Quai, six.	1
Pouvons-nous y arriver ?	Rupert Flemming a été la rencontre avec quelqu'un, Donc j'avais Interpol envoyer une photo de son ordinateur portable.	6
Est-il possible il piraté Interpol ?	Voilà ce que je pensais.	1
Je ne sais pas, une histoire à propos de terrifiant bactéries qu'il a trouvé?	Mais il avait aussi nous dire que si nous ne pouvons pas trouver un chef de file dans la preuve, nous devons nous pencher ce qui manque.	6
At-il montrer à la réunion ?	Vous ne pouvez pas répondre aujourd'hui Trop risqué.	2
Il a le vrai nom de Python?	L'anonymat est tout dans le Web profond. Ce Darko touche la clé à I.D-ing et la mise en cage ce serpent.	4
Me demandez-vous pas de suivre les ordres, Avery ?	Je vous demande à attendre avant que vous faites.	4
Hé, n'est pas qu'un de vos informateurs confidentiels ?	Frais !	1
Est votre famille de Toulouse ?	Ouais.	1
Je pense que ce, comme, contre la loi ou quelque chose, non ?	Désolé, Bernie.	1
Je suis désolé ...sommes-nous courir après un fantôme ?	Plus comme une identité virtuelle créé par un hacker.	2
Vous souvenez-vous Paris ?	Oh ...	4
Teddy ? Reste avec moi.	Avery, il n'y a pas de tir.	6
de Python certainement à la hauteur de sa réputation, est-il pas ?	Pablo Escobar du Web profond.	1
Avons-nous tout suivi de la chance la source des commandes à distance de l'arme ?	Il a reçu des commandes à travers le Web profond.	4
Une version bêta début sans informations de connexion ? Il est à peine vaut rien.	Bien. ( soupirs )	1
Fichier texte ? Mettez ça sur l'écran.	Qu'est-ce que c'est que ça ?	5
At-il jamais mentionner la première fois il a été donné le nom Python ?	Il a fait.	1
Rav -- ?	Je suis déjà sur lui, D.B.	1
Avez-vous une photo de Dante ?	Je l'habitude d'avoir une boîte à chaussures pleine. Mais je ne sais pas, je juste -- Il a juste obtenu trop douloureux.	2
Est-ce que mon Dante ?	Vous avez besoin à l'étape aside --	6
Avez-vous entendu que ? Pouvez-vous imaginer le montant de la douleur vous avez causé cette pauvre femme ?	La maison de ma mère. Vous êtes dans ma maison.	5
L'ingénierie sociale et d'espionnage sur votre propre mère ? Il ne va pas inférieur à celui.	Maintenant, maintenant, Ryan Avery. Vous avez aucune idée qui vous avez affaire.	5
Ma chambre ? Vous saisir les pailles, Directeur adjoint Ryan. Tu n'as rien !	Un modèle légèrement vêtues sur ton mur ? Voilà aussi proche que vous jamais obtenu d'une vraie fille.	5
Vous avez trois ensembles de feuilles plié dans votre placard, à la main. Est-ce parce que vous étiez encore pipi au lit lorsque vous étiez adolescent ?	Fermez juste votre bouche!	4
Attendez, vous vous-pensez Squamata est hébergé ici ?	Python suffit de laisser échapper quelque chose.	1
Alors, est-ce cela ?	Il ya une seule façon de savoir.	1
Hé, vous soyez prudent avec ça, d'accord ? Il est seulement le plus important morceau de matériel J'ai jamais mis mes mains sur	Je comprend.	1
Toute idée sur la façon Python obtenu que la lame dans son ancienne chambre ?	Ouais, il a noté l'ordinateur de sa propre mère.	1
Tu rigoles ?	Il serait déjà slurring son chemin par quelque chanson à boire il a juste composé.	5
C'est pour ça que tu ne m'as pas dénoncé, hein ?	J'ai vérifié dans ses comptes. Sutton doit beaucoup d'argent.	5
Ça semble sympa, d'accord ? J'apprécie l'offre, vraiment, mais je ne veux pas m'imposer.	Pour avoir sauvé ton cul, je pense que je mérite d'avoir la seule personne à mes fiançailles à qui je veux vraiment parler.	6
Saviez-vous qu'une Commission Présidentielle enquêtait sur les attaques ?	Il est temps de partir.	4
Ce justicier pense que je mérite de mourir ?	Une escorte est en route. Je vous appelle quand elle sera là.	5
Ressler a donné son accord ?	Mes hommes vont vous conduire à l'avion. De là, vous partirez vers Quito.	5
Donc tout ça, c'est juste pour couvrir vos arrières ?	Je doute que Hitchin soit d'accord avec vous.	6
Je peux vous donner un petit conseil ?	Je vous en prie.	1
Avez vous des preuves que la Cabale existe ?	Des noms de membres de la Cabale ont été publiés.	1
Pensez-vous qu'elle est innocente ?	Mon travail n'est pas de déterminer sa culpabilité ou son innocence.	4
deadnotalive.org ? C'est le vrai nom ?	Quelqu'un avec le pseudo "Arioch Cain" à mis sa tête à prix.	4
Tu peux enlever le site ?	Il est décentralisé, en cache sur plusieurs serveurs à travers le monde. J'en enlève un, et deux de plus réapparaissent.	2
Il fond dans la bouche, n'est-ce pas ?	Ou ma main. Je suis bon dans tout les cas.	1
Dites-moi, Mr Buckley, croyez-vous au coup de foudre ?	Je ne sais pas. Je pense que l'amour est plus un goût acquis.	4
Et l'avez vous déjà acquis, l'amour ?	Oui. Une fois.	1
Peut-être que ça le sera. Qui sait ?	J'ai aimé Asher Sutton dès l'instant où j'ai posé les yeux sur lui.	5
J'ai pas été assez clair de comment ça marchait ?	Je l'aurai vendredi.	5
- T'es sur ?	- Oui , tout va bien.	1
Il a dit que c'était bon.	Je l'ai entendu.	1
On en a pas fini.	On dirait que je me suis fait un nouvel ami.	6
C'est le créateur du site ? Vous êtes Gavrilo Princip ?	Son vrai nom est Gavin Delgado.	1
Donc vous ne partagez pas l'opinion de l'agent Ressler qu'elle soit innocente ?	Elizabeth Keen est un agent dormant Russe.	4
Vous ne me croyez pas ? Essayer une couche de quatre UDP / TCP dans la pile OSI.	Agent Navabi ?	6
Vous ferez quoi ? Me cibler avec une attaque DOS ?	En fait, je pensais plutôt à un million de requêtes répétitives.	2
Tu t'es mis dans le pétrin, c'est ça ? Raconte-moi. Laisse-moi t'aider.	Qu'est-ce que tu connais de la boxe clandestine ?	5
Russes ?	J'ai engagé un detective privé pour voir si un accord était possible. Ils ont trouvés des morceaux de lui le long d'une rivière.	6
Est-ce-que tu viens juste de dire que nous devons la tuer ?	Aram, écoute-moi très attentivement. C'est ce que j'ai besoin que tu fasses.	5
L'agent Ressler sait ce qu'on fait ? Il sait pour l'agent Keen ?	J'ai appelé, mais il témoigne toujours devant la Commission.	2
Ils vont venir pour toi, tu sais ?	J'y compte bien.	1
Arioch Cain ?	Vous ?	1
Vous ?	On dirait que vous avez vu un fantôme.	5
Oh, mon Dieu. C'est... c'est du sang sur ton col ?	Qu'est-ce que tu as fait ?	6
Lui en avez-vous donné trop ?	Mlle Claythorne, je vous ai prévenu sur le fait de devenir hystérique.	5
Général, avez-vous déplacé les statuettes ?	- Quoi ?	5
Désirez-vous de l'attention ? - N'importe quel genre d'attention ?	- De quoi parlez-vous ?	2
Pouvons-nous simplement déjeuner ?	Ce fut une affreuse nouvelle concernant Mme Rogers.	2
- Plus de chirurgie, alors, docteur ?	Les gens ne meurent pas sans raison !	1
- Et si je le faisais ?	Je ne veux pas être fouillé comme un criminel !	2
Est-ce vrai ?	J'ai eu des problèmes de santé, oui.	1
Général, allons-y ! Juste des calmants légers.	Comme je l'avais dit.	1
Vous pourriez peut-être m'appeler John.	Merci, John.	1
Vous avez déjà eu le sentiment d'être chassé, Pansu ?	Arrêtez de m'appeler comme cela.	5
Vraiment ? Parce que M. Owen, peu importe qui il est, en sait beaucoup sur nous.	Pas sur moi en tout cas.	2
Vous ne l'avez jamais touché ?	Je n'ai jamais voulu m'approcher de l'un de ces gros porcs.	1
Votre valise est-elle faite ?	Elle mourut de la grippe espagnole, après la guerre.	6
Amenez quelques chaises, voulez-vous.	Que se passe-t-il ?	5
Je ne peux pas dormir dans ma chambre, non ? Mon épouse.	Oui, évidemment Bien sûr.	1
Votre employeur ? Votre employeur est fou.	Quoi qu'il en soit, il ne me reste que cela.	5
Elle s'est suicidée ?	Cela a même fait la une du journal local.	1
Marston a reçu du cyanure, pourtant. - N'est-ce pas, Pansu ?	- Du cyanure ? Je suis presque sûr de cela.	1
Quoi, le juge ?	Connu comme un juge impitoyable.	1
Quelqu'un a fait cela ?	Ce n'est pas un fichu accident.	1
Je peux imaginer croiser un docteur... un juge, mais quelqu'un comme M. Lombard ?	Nous nous sommes croisés à présent.	1
Nous nous sommes croisés à présent. N'est-ce pas ?	M. Lombard, Blore m'a dit que vous aviez un revolver.	5
Il a une arme ?	Je l'emmène partout.	1
Quelqu'un reconnaît la voix de M. Owen sur le disque ?	Oublions-nous le pistolet ici ?	5
Eh bien, maintenant, elle s'est tût, n'est-ce pas ?	C'est lui qui ôte les statuettes.	6
Puis-je ? J'apprécie les tâches domestiques.	Elles sont relaxantes.	1
Vous avez réellement faim ?	C'était une tâche dure...que de s'occuper de Rogers.	1
Qui, Wargrave et Armstrong ?	Attendez-moi ici.	1
- Et vous l'avez trouvé ! Ou peut-être que non. Vous trembliez comme une femme, c'était de la comédie, n'est-ce pas ?	Je n'ai rien fait à Rogers.	2
- Vous diriez cela, non ? Comme vous avez dit que votre arme a été volée.	Vous êtes vraiment un fichu idiot de première catégorie, et de niveau cinq étoiles avec ça.	5
Vous aimez oncle Hugo, n'est-ce pas ?	Oui.	1
Serez-vous ma tante ?	Oui.	1
Prête, ma vieille ?	Prête ? Je ne pense pas que Mlle Claythorne puisse frapper la balle.	6
Allumer un feu sur la pointe, demandant de l'aide ?	Pas avec ce temps.	2
Et si je l'avais, je ne vous tuerais pas tous d'un coup, non ?	- Comment pouvons-nous le savoir ?	4
- Car c'est un par un, selon le poème, n'avez-vous pas fait attention ? Et il n'est mentionné nulle part un pistolet, n'est-ce pas ? Espèce d'imbécile, crétin !	Je vous suivrai.	6
Est-ce vrai ?	Arrêtez de m'appeler comme ça.	4
Est-ce vrai ?	J'avais le pouvoir de condamner à mort des hommes et femmes pour leurs crimes.	1
Avez-vous vu celle d'Edward Seton ?	Je me souviens d'Edward Seton, dans les journaux.	4
Arrêtez, voulez-vous ? Arrêtez !	Vous pensez qu'on en a pas assez de vous voir... haleter, fumer... vous agiter et faire les cent pas.	6
Quoi, vous pensez que j'y ai fait quelque chose ? Je vais chercher une autre bouteille qui n'a pas été ouverte.	- J'ai besoin d'eau.	6
Un lustre dans la chambre ?	Ils sont snobs, non ?	1
Tué par balle ? - Vous êtes sûr ?	- Regardez-le !	1
Que ça vous serve de leçon. Soyez plus discret. Vous ne voulez pas finir avec un nez en sang ou vous déchirer l'intérieur parce que ce n'est pas marrant pour vous d'avoir pleins d'entailles.	Merci.	1
Vous reviendrez pour ça ?	Je dois y aller.	1
Si Philip avait l'arme auparavant, il l'aurait pris avec vous quand vous êtes allé chercher Armstrong, n'est-ce pas ?	Vous auriez pu vous faufiler de votre chambre et l'y mettre.	4
Pourquoi est ce que c'est toujours vous qui comprenez ? Résoudre le puzzle. Armstrong l'avait dit.	La nuit a été longue.	1
Sommes-nous déjà morts ?	Quoi ?	5
Je refuse de passer une autre nuit ici, vous ?	Je pense qu'on est surveillés.	2
Vous vous êtes retournée un moment et vous ne pouviez pas rattraper Cyril ?	- Hugo, vous ne pensez pas...	2
Il n'y en a plus pour longtemps, hein ?	Pourquoi faites-vous ça ?	5
Elle a une adresse ?	Ouais.	1
Katie, as-tu appelé cette ouvrier ?	Steven ?	4
- On sait qu'il a besoin de temps.	- Des rénovations ?	6
Chef, je peux vous parler ?	Ouais.	1
Et si je trouvais un moyen de réparer ça ? Que vous sauviez la face, en gagnant de l'argent ? Une grosse quantité d'argent.	Et bien, je constate souvent que l'argent à un effet positif sur mon état d'esprit.	6
Où les avez-vous trouvés ? À l'intérieur du corps, n'est-ce pas ? Elle les a avalés ?	Vous les voulez, ou pas ?	5
Vous les voulez, ou pas ?	Êtes-vous sérieux ? Vous connaissez la valeur de ce lot ?	5
Êtes-vous sérieux ? Vous connaissez la valeur de ce lot ?	Ouais.	1
Avez-vous trouvé qui a fait ça ?	Écoutez, vous avez votre argent maintenant. Quelles sont les chances que vous me fassiez une faveur ?	5
Et cela clôt cette affaire ? Pour de bon ?	Ouais.	1
Vous vous sentez mieux d'avoir arrangé les choses ?	Tu l'as blessée ?	4
Tu l'as blessée ?	Qui ?	5
Alors ?	Pourquoi j'aurais fait ça ?	4
Megan... as-tu peur de moi ?	Manifestement, non.	2
Comment le travail de miel? Les choses de mieux en mieux au bureau ?	Maman, je ne veux pas pour parler de cela.	4
Non. Ah bon ?	Je sais. A propos du temps, non ?	1
Je sais. A propos du temps, non ?	A propos du temps pour quoi ?	5
Est-il clair ici pour vous ?	Ce mieux ?	6
Monsieur ? Monsieur, êtes-vous d'accord ? Je dois ESU à 1,298 Horizon Cour.	Je l'ai vu. Il a tué Isabel.	5
Toute chance il a laissé des empreintes digitales ?	Malheureusement, il ne ressemble pas à elle.	2
Krumitz, vous voyez cela ?	Quoi ?	4
Isabel ?	Tu me manques vraiment les gars.	5
Vous souvenez-vous de son visage ?	Je pense qu'il se détourna.	2
Pensez-vous il pourrait être étendu pour vous ?	Il est très fragile. Je ne suis pas sûr que tout est liées à ce crime. Mais il n'y a rien dans son comportement ou le comportement qui indiquent à moi il fabrique qu'il a son histoire.	2
Tu vas répondre à cela ?	Nan.	2
Pouvez-vous ?	Ouais.	1
Les gars ?	Oh oui.	1
Cette chose est connecté à l'Internet ?	Vous êtes à la recherche au niveau du dispositif que les logiciels malveillants chargé sur l'ordinateur portable d'Isabel.	1
Un "buddy" ? hein?	Bien, si Isabel et son petit ami Ethan utilisé ce jouet à continuer leur relation sexuelle après elle a déménagé à Tampa pour le travail.	6
Manage à Trois ?	Chaque fois Isabel et son petit ami a fait l'acte, ce troisième dispositif est venu en ligne.	6
Attendez, vous dites ... quelqu'un détourné Signal de sexe sans fil de Isabel et a été ... ce qui, en regardant ?	Eh bien, pas exactement.	2
L'achat d'un jouet sexuel était maladroit ... mais de la lingerie était tout à fait naturel?	Eh bien, maintenant ...	4
Brody, je suis votre frère, d'accord ? Je besoin de votre aide sur ce coup.	( soupirs ) Je ne peux pas vous aider, en Jordanie.	2
Attendez, Krummy, vous voir cela ?	Cela dit quelqu'un d'autre piraté Isabel vidéo-chat programme WeDial.	1
Tu rigoles ?	Notre objectif peut-être, s'immiscer dans quelqu'un.	2
Pouvez-vous saisir un de Tristan Jenkins brosses à dents et obtenir pour D.B. Russell dans le bureau de terrain ? Regardez, un simple test d'ADN devrait nous dire si notre tueur de Tristan.	Ouais, mais avec dix moniteurs ? Je veux dire, il est probablement regarder plus que juste Isabel.	6
Hé, mec ... Vous aimez ?	Ouais.	1
Si on vous donnait occasion pour aider Francine avant elle a eu des ennuis, auriez-vous ?	Je l'aurais fait tout pour l'aider.	1
Alors, Tristan fait quoi ? Collecte des moments heureux de la vie de ses victimes ?	Ma maman et papa sont toujours mariée.	6
Tristan pense cette collection étrangers de hasard sont ses proches ?	Pour lui, ils ne sont pas étrangers au hasard.	1
Mais je suppose que le sang et la famille ne signifie pas grand-chose de quoi que ce soit à vous maintenant ?	Regardez, cela est faux, en Jordanie.	2
Vous êtes sûr que ce soit tout ?	Je pense que oui.	1
C'est dur de respirer, n'est-ce pas ?	- Je vais me laver les cheveux.	6
Y a des gens chez moi. C'est fou, non ? Des amis de Frankie sont passés à l'improviste.	- Frankie est encore là ?	5
- Frankie est encore là ?	- Oui !	1
- Oui !	- Frankie?	6
Tu veux parler, faire un album, te venger ?	Qui vous a parlé de Sol ?	6
Vous avez déjà un avocat ? Je connais tous les avocats de l'État.	Elle a engagé la plupart.	5
Vous étiez au courant, pour Sol ? J'étais la seule à l'ignorer ?	J'étais sous le choc, je te jure.	1
- Vous avez bloqué leurs cartes ?	- Je sais. C'est horrible.	1
Tu m'entends ? Chez moi ! Et tu sais quoi ? Je vais te raccrocher au nez !	Frankie ? Ça va ? Que s'est-il passé ?	5
Tu vois pourquoi elle ne t'appelle pas ?	Plus ou moins.	3
- Peux-tu me regarder ?	- Pardon, je lis.	2
Tu ne lis pas Menuisier Magazine.	J'ai des surprises aussi.	1
Tu es menuisier en secret ?	Je déteste qu'à peine une semaine après avoir détruit ma vie, tu passes déjà aux aspects juridiques, aux avocats et... aux cartes de crédit bloquées...	5
Coyote est sorti de désintox ?	Tu ne le savais pas ?	1
Il vit là-bas ?	Tu l'as pas vu depuis le coup à la Stanley Kowalski devant chez toi ?	1
Sérieux ? Tu vas faire ça maintenant ? Tu vas parler de toi, alors que c'est la première fois qu'ils sont ensemble, tous les quatre, depuis...Tu sais...	Gay-maggedon ?	5
Gay-maggedon ?	- Arma-gaydon ? C'est mieux ?	4
- Arma-gaydon ? C'est mieux ?	- C'est mieux, oui.	1
Ce n'était pas insinué quand j'ai dit d'aller chercher les enfants ?	Tu as dit que tu allais chez Frankie et que je devais...Oui, c'était sous-entendu.	1
Quelqu'un veut un verre ? Sauf l'alcoolique ?	Moi, je veux bien.	1
C'était réel, tout ça ?	Tu vas te faire de nouveaux souvenirs, Frankie.	4
J'avais ça pour mon baptême ?	Et moi avant toi.	1
Tu as parlé à Rafael ?	Lina a confirmé. Tu comprends, Abuela ?	5
Lina a confirmé. Tu comprends, Abuela ?	Jane, tu lui as parlé ?	1
Jane, tu lui as parlé ?	Pourquoi ? C'est lui qui a demandé à Michael.	2
- Ce n'est pas le bon moment ?	- Ne me dis pas de me taire, - c'est toi qui m'a amenée ici.	6
Désolée, mais c'est bizarre.	Je me servais de toi.	5
Ils vous en font en retour ?	Tanner m'en fait.	1
Attends, t'es là pour me voir ou pour voir Jane ?	Euh, les deux.	5
Tu as déjà pensé à l'auto-bronzant ?	Maintenant on avance vers la porte d'entrée. Et nous voyons...	6
Je te vois à la répétition de baptême tout à l'heure ?	Si son emploi du temps criminel le lui permet.	1
Est-ce que ça va ?	Où trouve-tu les mots pour dire que ta tarée d'ex-femme s'est inséminée elle-même avec ton sperme volé ?	2
Donc ta sœur vient au baptême, ou...? Elle n'a pas confirmé.	Non, je n'ai pas eu de nouvelle.	2
Ça ne te rappelle rien ?	Désolé, pour être honnête, je n'écoutais pas cet appel.	4
Tu te souviens quand on l'avait piégée en lui faisant croire que j'avais encore des sentiments pour elle ?	Et je pense qu'elle ferait n'importe quoi, même dénoncer sa propre mère, si elle pense avoir une chance avec toi.	1
Ça va ?	Oui, oui. 	1
- Je ne peux pas déjà le laisser.- Chérie, tu te souviens de ce que tu disais quand tu étais enceinte ?	On a besoin d'un signe. Une façon pour toi de me dire quand je suis en train de laisser ma maternité guider ma vie.	6
Tu penses que c'est la bonne chose à faire ? Tu sais, en tant que P.E. ?	Eh bien, évidemment, les fans et la presse auront les boules.	1
C'est une figure de style ?	Entrepôt de Luciana.	6
Qu'est ce que c'est ? Ton journal intime ?	- C'est pas un journal intime.	2
Vraiment ?	Je n'ai pas dis ça.	1
Parce que tu ne veux pas être avec moi ?	I didn't say that.	4
Quelle est l'alternative ? On l'accueille dans la famille ? On la supporte à Thanksgiving ?	Je me suis servi de ma seule poire à jus. Bon appétit !	6
Et après ? Elle ne dit pas à Mateo qu'il a un frère ou une soeur jusqu'au jour où il le découvrira ?	Je signe pour qui ?	6
Vous savez quoi ? Je m'inquiète déjà assez avec cette histoire de programme sup.	- Arrête, tu vas y retourner.	5
Et concernant la concordance avec le nom d'un visiteur du vignoble ?	C'est difficile, à cause de la dégradation de l'encre et des tâches de vin.	5
Alors, les mamans, voulez-vous partager quelque chose ? Tant que vous êtes là ? Tant que bébé est là ?	Oui, moi.	1
Je veux travailler. Ça fait de moi quelqu'un d'horrible ?	Mamans, arrêtez. Il n'y a pas de bon choix, parce qu'on est tous différents.	2
Je suppose que tu as lu le texte ? C'est lorsque Blanca retrouve Santos après une séparation agonisante. Est-ce vraiment toi ?	Oui.	5
On est prêts ?	Une dernière chose, Janie.	2
Michael et Lina, en tant que parrain et marraine, promettez-vous de soutenir ces parents dans l'éducation de cet enfant, de le faire baigner dans la sagesse et l'affection ?	- Nous le promettons.	1
C'est vrai ?	Je ne te l'ai pas dit, parce que, eh bien, cela semblait si important pour toi de le voir en premier.	1
Laquelle de nous deux est la pire ?	Il n'y a pas que ça.	5
Tu te souviens combien tu étais excitée quand tu nous l'as annoncé ?	On est accepté à l'université !	6
Xiomara, Peut-on parler de ce qu'il s'est passé, s'il te plaît ?	Qu'est-ce-que tu veux dire ?	5
Il a bonne mine, hein ? Il a comme un certain éclat.	Je ne sais pas, il a été si distant ces derniers temps.	4
Tu crois vraiment que j'aurais réagi à ce genre de plan ?	- Jane, écoute...	5
- Et être distant, et une sorte d'abruti exprès ?	Jane, je-j'essaie de te parler.	5
Ça va ?	Oui, je vais bien.	1
Mais est-ce que c'est ce que tu veux ?	Je ne veux rien de tout ça.	2
Je suppose que d'après cette réaction, c'est ce que tu veux ?	Merci.	5
Mais tu veux avoir ce bébé ?	Eh bien, je ne veux pas que tu subisses un avortement. Ou déménages en Russie.	4
Elle veut une photo de moi. Elle est incroyable. Est-ce que tu as du rouge à lèvre ?	Attends, une minute, s'ils font tout pour que Rose remarque que Luisa a disparu, alors Rose n'est pas celle qui l'a faite kidnapper.	6
C'est vrai que je n'ai pas eu le rôle ?	Ce n'est pas le bon moment. On tourne une scène dans laquelle je vais défier la mort.	5
Tu trouves que c'est plus excitant que l'été ?	J'ai volé ton soleil ?	5
Vous le savez, hein ?	La mode actuelle veut que les noms soient un charabia unique, simpliste et facilement mémorisable.	5
Que pensez-vous de pigeonneurs ?	J'aime bien les pigeonneurs.	1
Vous allez sortir vous amuser ? Je vous suivrai bien, cette année a été dure, j'ai besoin d'un verre.	On ira au bar de Britta quand maman nous laissera partir. C'est bon, on a fini.	1
Tu vas revenir ?	Je pense.	1
Tu vas revenir ?	Probablement.	1
Elle a dit qu'elle avait un entretien ?	Six ans. Six saisons, hein Abed ?	6
Six ans. Six saisons, hein Abed ?	L'encourage pas.	5
Et si Shirley revenait, ça changerait ton opinion ?	Elle peut revenir dans notre formule mais je vois pas ce que ça apporterait.	2
On peut arrêter l'intrigue B et se concentrer sur la A ?	Je ne crois pas aux intrigues A.	2
Est-ce que ce duo peut fonctionner ?	Ce n'est pas à moi de le dire.	4
Vous voyez, Shirley, pas Shirley, quelle importance ?	Nous ne sommes pas des formules, et je me connais très bien.	5
Les choses fonctionnent selon une certaine structure. Si on s'en écarte, on est bizarre, si on s'y tient, on est ennuyeux.	Ça n'a pas plutôt à voir avec le fonctionnement de ton cerveau ? Sans vouloir te blesser. Mais n'est-il pas bousillé ?	5
Ça n'a pas plutôt à voir avec le fonctionnement de ton cerveau ? Sans vouloir te blesser. Mais n'est-il pas bousillé ?	C'est quoi le résumé de votre saison sept ?	4
Je peux prendre ta chambre ? Enfin si tu ne reviens pas.	Je vais revenir, enfin probablement.	2
Jeff, tu vas bien ?	Je suis pris de court.	4
Quelqu'un a vu ma cigarette électronique ?	On devrait lancer une association pour les gens comme toi.	5
Tes derniers crédits en criminologie sont-ils difficiles à Greendale ?	Le seul crédit difficile à obtenir à Greendale, c'est celui de la banque.	2
Vous vous rappelez du vendeur de crack ?	Si je m'en rappelle ? Tout le monde s'en rappelle.	1
Et pourquoi je porte une couche ? C'est pour se moquer de moi ?	Vous voulez vraiment que des gens vous habillent ?	5
Vous voulez vraiment que des gens vous habillent ?	Ce serait poli d'essayer.	4
Dans cette version, tu me diras souvent quoi faire ?	Je prends des médicaments dedans ? Je suis serein et fiable. J'aime ça.	5
Mais tu vas revenir, hein ?	Peut-être.	4
Un truc amusant est arrivé ?	On s'en fiche.	4
Tu vas bien ?	C'est vraiment ce que tu veux ?	5
C'est vraiment ce que tu veux ?	Bien sûr.	1
On vous a interrompus ?	Arrête d'être grossier !	5
Vous faites un final non autorisé ? Pas cool.	Abed, je sais que ça te réconforte de tout regarder à travers des objectifs, mais on disait juste adieu à cette pièce.	2
On peut les couper pour les emmener chez nous ? Je veux dire nous-mêmes ?	Bien sûr.	1
Mademoiselle ? Je dois m'excuser.	Pas envers moi, mais plutôt envers les Amish à qui vous ayez volé le look.	6
Tu vois le mec dans le box là-bas ? Jared "Leto-tôt pour ça" ? Il veut me prédire mon futur pour payer son pourboire !	Tu n'en as pas.	5
Je vois deux "M" ?	Pétasse ! Tu planques des MM's ?	5
Max, je peux en avoir un bout ? Une miette du crumble ? Caroline ne me laisse pas manger à cause de ma séance photo.	Vite ! Ne mâche pas, ne profite pas.	1
Il ne mange pas, n'est-ce pas ? Je ne veux pas qu'il ressemble au bonhomme Michelin pendant la séance photo de ma copine.	Je n'ai rien mangé depuis mardi !	2
Je pourrais nommer Max chef-pâtissier ? Et où est ce nouveau restaurant ?	Pour l'instant, il est encore en travaux comme mon visage il y a six mois. Mais en tant que manager, vous pourrez choisir votre équipe, et je vous laisserai même débaucher Max.	4
Max, tu as entendu ça ? Un lieu phare !	Quelqu'un m'a traité de phare ? Je vous préviens que si je ne viens pas dans ce nouveau restaurant avec vous deux, je vais en parler aux RH. Rodriguez et Hector, mes psychologues.	5
Quelqu'un m'a traité de phare ? Je vous préviens que si je ne viens pas dans ce nouveau restaurant avec vous deux, je vais en parler aux RH. Rodriguez et Hector, mes psychologues.	Serais-tu intéressé de rejoindre notre équipe dans le nouveau restaurant ?	5
Serais-tu intéressé de rejoindre notre équipe dans le nouveau restaurant ?	Si tu dis encore "notre équipe", je vais devoir y réfléchir.	4
On peut se dépêcher ? Mon cousin passe à la télé aujourd'hui, et je veux savoir s'il est vraiment le père. Comme ça je pourrais arrêter de payer la pension alimentaire.	Désolée. Elle est survoltée.	5
Tu as vu les Knicks récemment ? Son aide serait la bienvenue.	Selon ma fiche de pointage, je suis là depuis six heures déjà, donc je vais aller faire une sieste.	5
On est où, dans une maison close ?	Bébé, je crois que c'est à toi.	6
Peut-on clairement établir qu'on ne fornique pas au resto ?	Ou dans l'appartement de Han.	5
Et si on en revenait au travail ?	Max et moi...	2
Pourquoi tu t'agites autant ? Y a des soldes sur les petites têtes ?	Je suis trop petit, trop gros...Choisis !	5
Joe vous a parlé de ma grosse promotion ?	Bien sûr.	1
Tu m'as vu par la fenêtre du Today Show, pas vrai ?	Tu as dit que tu étais en Amérique sur Facebook, espèce d'idiot.	2
Je suis qui, Woody Allen ? Roman Polanski ? N'importe quel réalisateur des années 70 ?	Vous avez couché avec mon innocent petit garçon ?	5
Vous avez couché avec mon innocent petit garçon ?	Pas si innocent que ça.	5
Pro ? Elle a giflé une femme, car elle portait des contrefaçons.	Je sais. J'ai encore la trace de sa main.	5
Je peux garder la toque ? Vous ne voudrez pas la récupérer. Je transpire comme un bœuf.	Ne nous virez pas à cause de Nash. On ne pouvait rien y faire.	6
Tu as vraiment besoin d'exposer 60% de ta poitrine ?	C'est pas de ma faute. Ils font ce qu'ils veulent. Celui de droite vient de se lancer dans la comédie.	1
Il est là ? Je vais chercher un menu enfant.	Ils ne viennent pas. Sa mère a trouvé les photos coquines que je lui ai envoyées.	6
"Je pars de JFK demain. Je m'envole demain matin."	S'envoyer en l'air le matin ? Ce n'est pas ce qui a mis Max dans l'embarras au départ ?	5
S'envoyer en l'air le matin ? Ce n'est pas ce qui a mis Max dans l'embarras au départ ?	OK, on aura qu'à aller a l'aéroport et les arrêter. Je vais nous acheter des billets et je les ferai rembourser, comme je fais pour les chaussures ou comme Tom Cruise avec ses femmes.	4
Mme, mettez-vous le côté s'il vous plait.	Je plaisantais. Je n'ai pas de bombe. Mais j'en suis une.	5
Puis-je voir vos billets ?	Belle journée. J'adore vos cheveux.	2
Vous allez à Paris. Première classe. Avec ce pantalon ?	Tu as acheté des billets en première pour Paris ? Tu es folle ?	5
Tu as acheté des billets en première pour Paris ? Tu es folle ?	Mes doigts ont agi seuls. C'est ma mémoire tactile de fille riche.	1
C'est trop tard pour dire que je la connais pas ?	M'dame, apportez-vous des explosifs ?	5
M'dame, apportez-vous des explosifs ?	J'ai des restes de Chipotle pour le petit-déjeuner. Est ce que ça compte ?	2
J'ai des restes de Chipotle pour le petit-déjeuner. Est ce que ça compte ?	Ça dépend de celui qui sera assis à côté de vous.	3
Tu sais ce qui ne sera pas dans l'avion ? Nous ! Nous ne partons pas ! Est-ce que tu as fumez le demi-joint que j'ai caché dans mon soutient-gorge ?	Tu as un joint ?	5
Tu as un joint ? Compte bancaire ? Tu as passé les contrôles avec de l'herbe ?	J'ai passé le CM2 grâce à l'herbe.	1
Tu es vraiment ivre, non?	Encore... quand tu as raison, tu as raison.	1
Maeve O'Brien est priée de se rendre à l'accueil. 	Nash, peut-être qu'ils vont nous surclasser du dernier rang vers le premier !	6
Tu as soudoyé un agent aérien avec un joint ? Du pain ? Ça ne valait pas le coup. Max, c'est du kidnapping.	Il n'est pas si jeune.	5
Quoi ? Ici ? On va travailler ici ? Je dois découvrir qui j'ai brutalement tué dans une vie antérieure et m'excuser.	Ça craint !	1
Ça va très bien. J'étais crédible ? Parce que je m'entraîne dans les toilettes tous les matins pendant une heure. 	Je sais, il faut que j'arrête d'y aller en même temps.	4
Salut, de quoi vous parlez ? Des tables que vous ignorez ?	On parlait des goûts de Sophie.	2
Quelqu'un aurait un couteau ?	Qu'est-ce que tu fais avec ça par ici ?	1
Sophie, votre grand-mère était gardienne de crypte ?	Qu'est-ce que vous faites ?	6
Seulement un peu ? Voilà, c'est moi qui m'énerve.	C'est le stress du mariage.	5
Vous n'avez pas toujours été lesbienne ?	Bien sûr que si. Sauf pendant ces trois ans, quand j'étais scientologue.	3
Faites un tour, mesdames, on revient dans un mois. Tahiti, nous voilà. Je fais le petit fou, les dames adorent.	On devrait appeler ces robes par leur vrai nom : la dernière collection Emmaüs.	5
Max, tu as entendu ?	Ma vie est finie.	1
Max, tu as entendu ? Des filles qui ont plus mauvais goût que Sophie. Laissez-les passer.  Maintenant, on doit rester ici et les laisser acheter les robes. J'ai retrouvé l'espoir.	Max, Caroline, par ici !	5
Ça a duré quoi, une seconde ?	J'ai fait la queue pour vous, venez !	5
Tu me dis que Versace a été assassiné mais que le créateur de cette chose court toujours ?	Je sais. Titi va nous faire un procès pour contrefaçon. Il faudrait des rouleaux de papier-toilette géants là-dessous.	1
Ce n'est pas fini ?	Si jamais vous trouvez un Xanax, il est à moi.	6
Sophie, vous en êtes sûre ?	Oui, évidemment.	1
Des pleurs dans une cabine d'essayage ?	Les grosses fesses sont à la mode.	5
Tout va bien ?	Ce n'est pas moi mais ça va.	3
C'est vrai ? Dans ce cas, elle devrait le dire. Maintenant.	Sophie, je pense que vous avez un style très personnel.	5
Han est dans le micro-ondes et tu vas l'allumer ?	On a essayé, tu sais bien qu'il n'entre pas. Le seul truc pour lequel il est trop grand. 	2
Attends, c'est le Warsaw Times ? Je croyais qu'on parlait du New York Times.	Le New York Times ? Celui-ci est beaucoup plus exclusif.	1
- Ça a duré quoi, une seconde ?	- Oui. Tu viens de passer du bonheur à la Pologne.	1
On va toujours à la pizzeria ce soir ? Je ferme le resto plus tôt pour ton anniversaire, et pas parce que la ville enquête sur cette histoire de moisissures.	Absolument.	1
Vraiment ? Je croyais que le meilleur ami de la femme était quelqu'un de plus gros qu'elle.	C'était à ma grand-mère russe.	5
Sophie s'y attend ?	Bien sûr. Elle n'aime plus les surprises depuis que sa maison familiale a été brûlée par un ouvrier mentalement instable.	1
Un préservatif plein de viande ?	C'est une Lamborghini ? Attendez. C'est ma Lamborghini ?	6
C'est une Lamborghini ? Attendez. C'est ma Lamborghini ?	Oui, une Lamborghini Aventador Roadster.	1
Pourquoi on ne nous laisse jamais rien ?	C'est une voiture de sport à 450 000 $.	5
Je t'ai toujours plus aimée que Max. Tu sais ça, hein ? 	Vraiment ? Parce qu'hier je t'ai entendue crier à Max "Caroline aura 47 ou 48 ans ? Parce qu'elle agit comme si elle avait 65 ans."	5
On t'a acheté un garçon ? Vous étiez riches !	La voiture est juste là et on peut même pas l'utiliser. 	6
Je peux te demander un service ?	Tu ne prendras pas la voiture pour faire ta demande à Sophie.	2
Mais on peut quand même la conduire ? J'utilise ma crème depuis un mois.	C'est quoi la règle n°9 du Club Lanborghini ?	5
T'as recommencé. Tu m'as droguée, c'est ça ?	Évidemment !	1
T'as un stylo et du papier ?	Tu savais que je ne voulais pas le faire !	5
Tu as pris une voiture de 450 000 $ une voiture qu'on est même pas sensées toucher pour faire une virée dans les Hamptons ?	Tu voulais venir ici.	1
Tu as traversé la dune jusqu'à la plage ?	J'ai pas fait exprès.	3
Il y a des éraflures ? Descends et aide-moi à chercher des éraflures.	Tu disais que t'étais plus drôle dans les Hamptons.	5
Comment ça "oh oh" ? On est bloquées dans le sable ?	Tu as correctement identifié le sens de "oh oh".	1
Tu sais ce que tu es ? Imprudente.	Tu sais, tout ce temps, je croyais que t'étais une garce "marche ou crève".	5
Tu googles "garce marche ou crève" ?	J'aimerais bien mais je n'ai que deux barres.	2
Tu stockes des centimes, et je sors de "Tout à 1 euro" les mains vides ? Là je suis en colère.	Prépare-toi.	5
Comment t'as fait ? T'as pété pour nous sortir de là ?	Sérieusement, Caroline, accélère.	5
On se la joue Thelma et Louise ?	Quoi, on se jette d'une falaise ?	5
Vous avez rendu la voiture à temps ce matin ?	Juste à temps, grâce à Caroline.	1
Tu n'as pas eu d'amende ? Hier, j'ai été arrêté pour être entré dans un magasin bio.	J'ai encore du sable dans les cheveux.	6
Il fait sa demande au diner ? Il va faire quoi ? Lui passer l'agneau au doigt ? 	J'aime ça. Tu sais, je voulais te dire non et te faire languir pendant des heures, mais...	6
Salut, je suis Murray. Vous avez commandé du curry de tomates à la hâte ?	Je sais pas. Ça a déjà été payé ?	3
Je sais pas. Ça a déjà été payé ?	Alors, oui, on l'a fait.	1
Il y a des samoussas là-dedans ?	Tu veux des naans ? Parce que celui qui les a commandé n'en aura que naan.	5
Vous avez vu Murray avec notre curry de tomates à la hâte ?	Non, désolée.	2
Son téléphone a une application de fertilité ? Mon téléphone est si vieux qu'il peut pas tomber enceinte.	Ça nous dit quand elle est le plus fertile. En fait, un petit singe nous le dit.	1
C'est quoi son nom ? George, le trop curieux ?	Oleg, c'est le moment.	6
Ça te dérange si j'utilise ton ventre comme un plateau pour pouvoir manger pendant qu'on le fait ?	Ça m'a déjà dérangé ?	2
Ça m'a déjà dérangé ?	Maintenant, je dois oublier tout ça juste pour surmonter cette journée.	6
OK, Max, cette fois, tu peux faire le truc d'explosion de la main avec lui ? J'ai déjà essayé, mais je suis juste pas bonne aux trucs de mains. Demande à n'importe qui en prépa à Yale.	Tente juste le coup ! Tu croyais aussi ne pas pouvoir manger de la bouffe qui avait été piétiné.	5
Il y a un cours que je peux prendre ?	Je vais chercher le reste du loyer.	5
Alors, c'est quoi ce nom "Mookie" ? Un diminutif ? Un prolongement ? Max, grouille-toi, meuf !	OK, tu devrais avoir 800 $ et voilà le reste.	6
Tu me fais payer le loyer plus cher ?	C'est pas du tout ça.	4
Et Max Black est-il même ton vrai nom ?	C'est un vrai nom.	4
Tu peux pas lâcher l'affaire ? D'accord, j'ai un peu abusé. Tout le monde abuse un peu. Regarde ce que Dieu a fait à Han.	Ne m'embarque pas dans ton petit Pretty Little Liars.	5
Pourquoi ? Pour qu'on soit à la même taille ?	Bien joué, Caroline.	2
Tu vois, Han ? Travail d'équipe.	OK, lisons nos dernières critiques sur Internet.	1
Alors tout le monde se fiche que Max me volait 25 $ par mois ?	C'est exact.	1
Tu lui as fait payer plus, à lui aussi ?	Vous allez découvrir où on est, bien assez tôt.	6
Non, c'est pas l'une de ces "escape room" où on nous enferme dans une pièce, où on doit bosser en équipe pour sortir ?	Bienvenue dans l'Escape Room, où on vous enferme dans une pièce, où vous devez bosser en équipe pour sortir.	1
Quoi ? Nous te foutant une raclée ?	Ensemble, évidemment.	1
Alors si je comprends bien. Les gens sont volontaires pour être enfermés dans une petite pièce ? Vous voyez, ça, c'est un truc de blancs.	C'est une manière fun d'apprendre à travailler ensemble pour résoudre un problème.	1
Je dois m'échapper de ça aussi ? Ça fait partie du jeu ?	C'est un mauvais moment pour te dire que c'était le plan de ton cheval ?	1
C'est un mauvais moment pour te dire que c'était le plan de ton cheval ?	Avant de commencer, il me faut vos téléphones pour que vous n'utilisiez pas Google.	5
C'est un truc pour le travail d'équipe et tu n'es pas dans l'équipe. - Pas vrai, Han ?	- Elle peut rester.	2
C'est notre version de la réconciliation sur l'oreiller ?	Je ne vois rien.	5
Je croyais ça avant. Vous savez où ça m'a mené ? En Pennsylvanie, sans voiture.	Celui de Schwarzenegger est grand, celui de Fox petit.	6
Sérieux, t'es encore là-dessus ? Ma sœur a perdu ses deux pouces dans un accident de moissonneuse, et elle en a pas fait autant un plat. 	Voilà 25 $. De l'argent secret, alors que ça reste secret.	6
Ces gros jumeaux ? Car ça veut rien dire, et on dirait qu'ils étaient défoncés souvent.	OK, Oleg, enlève ton pantalon.	5
On pourrait être plus classe et attendre d'être dans le taxi ?	Quoi ? On va le faire au-dessus de tasses à thé. C'est plutôt classe.	2
Tu sais quoi ? Pulvérise ce truc dans mes yeux.	Max, regarde.	6
Ça va ?	Oui, je crois.	1
J'ai sauté dans un trou pour des sentiments ?	Je suis vraiment blessée, Max. Depuis quatre ans.	1
On peut ré-éteindre les lumières ?	Seigneur, aidez-moi !	4
- Et tes vœux ?	- Arrête !	2
- Une carte de vœux ?	- Je n'écoute plus !	2
Tu l'as laissé aller se coucher ?	Il était de très bonne humeur, il avait jamais vu Maman, j'ai raté l'avion.	1
- C'est une fête ?	- Oui. Tu veux un muffin ?	1
Guy, on peut parler ?	Et comment.	1
On t'a déjà dit que tu étais un homme merveilleux ? 	Tu me le dis maintenant, non ?	4
Tu me le dis maintenant, non ?	C'est vrai.	1
Frankie, on se refait une partie de bataille navale plus tard ?	Je ne comprends pas.	4
Je viens t'aider ? Je sais que tu appréhendais. Je t'apporte mon étiqueteuse.	Je l'ai déjà, et je pensais que j'appréhenderais, mais mon travail de limites avec Sol a été très efficace, et je suis prête à tourner la page.	2
- Content, papa ?	- Faut pas pousser.	2
C'est ce qui est arrivé au garçonnet hollandais de ma mamie ? Bonjour, Hans.	Ah oui. Je l'ai cassé.	1
- Oui, hein ?	Mon Dieu !	5
Je leur laisse de la sauge pour se débarrasser de notre ju-ju ?	- Ça ira.	2
Avant de partir, et si on allumait la bougie de shabbat une dernière fois ?	- Ce serait sympa.	1
C'est bien ?	C'est bien.	1
Vu qu'on est avocats ?	Je comprends pas, tu veux qu'il signe ?	5
Je comprends pas, tu veux qu'il signe ?	Allez, c'est pas si mauvais !	1
Tu veux dire là où tu cites un précédent ?	Bien raisonné.	1
Tu l'attaques en justice pour son amour ?	Je t'avais dit que c'était pas prêt.	1
- J'ai écrit ça ?	- Oui. Soit ça, soit je suis amoureuse de Sol.	1
Ça va la faire régresser ! Tu es vraiment un...	Schmuck ? C'est le mot que tu cherches ?	4
- Tu sais où elle est ?	- J'ai une intuition.	4
- Tu vas le dire à Robert ?	- Et toi ?	4
- Et toi ?	- Il ne me le pardonnera jamais.	2
Ton mari te dit qu'il est amoureux d'un homme, et tu crois qu'il y a de l'espoir ?	J'ai pas dit que c'était logique.	1
Ça fait mal.	Tellement. 	1
- Surprenant, non ?	- Très.	1
On va laisser ça ?	C'est pas la première maison que je quitte aujourd'hui !	1